#  Fri Nov 16 19:52:40 2018 -- reformated by PCGen PrettyLST v6.08.00

###Block: Languages
# Template Name			Visible	Bonus Languages
Bonus Language ~ Azlanti	VISIBLE:NO	LANGBONUS:Azlanti

###Block: Racial Subtypes
# Template Name	Visible	Subrace
Deep Delver		VISIBLE:NO	SUBRACE:Deep Delver
Elder Dwarf		VISIBLE:NO	SUBRACE:Elder Dwarf
Exiled Dwarf	VISIBLE:NO	SUBRACE:Exiled Dwarf
Mountain Dwarf	VISIBLE:NO	SUBRACE:Mountain Dwarf
Arctic Elf		VISIBLE:NO	SUBRACE:Arctic Elf
Dusk Elf		VISIBLE:NO	SUBRACE:Dusk Elf
Savage Elf		VISIBLE:NO	SUBRACE:Savage Elf
Tower Elf		VISIBLE:NO	SUBRACE:Tower Elf
Dread Gnome		VISIBLE:NO	SUBRACE:Dread Gnome
Gear Gnome		VISIBLE:NO	SUBRACE:Gear Gnome
Lava Gnome		VISIBLE:NO	SUBRACE:Lava Gnome
Traveler Gnome	VISIBLE:NO	SUBRACE:Traveler Gnome
Drow-Descended	VISIBLE:NO	SUBRACE:Drow-Descended
Elf-Raised		VISIBLE:NO	SUBRACE:Elf-Raised
Human-Raised	VISIBLE:NO	SUBRACE:Human-Raised
Arena-Bred		VISIBLE:NO	SUBRACE:Arena-Bred
Deep Kin		VISIBLE:NO	SUBRACE:Deep Kin
Feral			VISIBLE:NO	SUBRACE:Feral
Mountain Clan	VISIBLE:NO	SUBRACE:Mountain Clan
Mystic		VISIBLE:NO	SUBRACE:Mystic
Avenging		VISIBLE:NO	SUBRACE:Avenging
Nomadic		VISIBLE:NO	SUBRACE:Nomadic
Slave Born		VISIBLE:NO	SUBRACE:Slave Born
Cosmopolitan	VISIBLE:NO	SUBRACE:Cosmopolitan
Country Folk	VISIBLE:NO	SUBRACE:Country Folk
Gutter Rat		VISIBLE:NO	SUBRACE:Gutter Rat
Imperious Human	VISIBLE:NO	SUBRACE:Imperious Human
Trailblazer		VISIBLE:NO	SUBRACE:Trailblazer
Versatile Human	VISIBLE:NO	SUBRACE:Versatile Human

###Block: Race Builder Humanoid Subtypes
# Template Name	Unique Key						Visible	Subrace			Race Subtype			Type
Adlet			KEY:Race Builder Subtype ~ Adlet		VISIBLE:NO					RACESUBTYPE:Adlet			TYPE:Race Builder Subtype
Dark Folk		KEY:Race Builder Subtype ~ Dark Folk	VISIBLE:NO					RACESUBTYPE:Dark Folk		TYPE:Race Builder Subtype
Sasquatch		KEY:Race Builder Subtype ~ Sasquatch	VISIBLE:NO					RACESUBTYPE:Sasquatch		TYPE:Race Builder Subtype
Reptilian		KEY:Race Builder Subtype ~ Reptilian	VISIBLE:NO					RACESUBTYPE:Reptilian		TYPE:Race Builder Subtype
Aquatic		KEY:Race Builder Subtype ~ Aquatic		VISIBLE:NO					RACESUBTYPE:Aquatic		TYPE:Race Builder Subtype
Shapechanger	KEY:Race Builder Subtype ~ Shapechanger	VISIBLE:NO					RACESUBTYPE:Shapechanger	TYPE:Race Builder Subtype
Giant			KEY:Race Builder Subtype ~ Giant		VISIBLE:NO					RACESUBTYPE:Giant			TYPE:Race Builder Subtype
Cold			KEY:Race Builder Subtype ~ Cold		VISIBLE:NO					RACESUBTYPE:Cold			TYPE:Race Builder Subtype

Snillorg		KEY:Race Builder Subtype ~ Snillorg		VISIBLE:NO					RACESUBTYPE:Snillorg		TYPE:Race Builder Subtype
Zif			KEY:Race Builder Subtype ~ Zif		VISIBLE:NO					RACESUBTYPE:Zif			TYPE:Race Builder Subtype
Taddol		KEY:Race Builder Subtype ~ Taddol		VISIBLE:NO					RACESUBTYPE:Taddol		TYPE:Race Builder Subtype
Obitu			KEY:Race Builder Subtype ~ Obitu		VISIBLE:NO					RACESUBTYPE:Obitu			TYPE:Race Builder Subtype
Mahrog		KEY:Race Builder Subtype ~ Mahrog		VISIBLE:NO					RACESUBTYPE:Mahrog		TYPE:Race Builder Subtype
Anumus		KEY:Race Builder Subtype ~ Anumus		VISIBLE:NO					RACESUBTYPE:Anumus		TYPE:Race Builder Subtype
Boggle		KEY:Race Builder Subtype ~ Boggle		VISIBLE:NO					RACESUBTYPE:Boggle		TYPE:Race Builder Subtype
Entobian		KEY:Race Builder Subtype ~ Entobian		VISIBLE:NO					RACESUBTYPE:Entobian		TYPE:Race Builder Subtype
Charau-ka		KEY:Race Builder Subtype ~ Charau-ka	VISIBLE:NO					RACESUBTYPE:Charau-ka		TYPE:Race Builder Subtype
