# CVS $Revision$ $Author$ -- Mon Jan 17 06:06:23 2011 -- reformated by prettylst.pl v1.39 (build 11455)
SOURCELONG:Core Rulebook	SOURCESHORT:PFCR	SOURCEWEB:http://paizo.com/store/downloads/pathfinder/pathfinderRPG/v5748btpy88yj	SOURCEDATE:2009-08
# Original RSRD Entry by: abernat
# Pathfinder RPG Entry by: Stefan Radermacher

# SIMPLE WEAPONS
# -- unarmed
# Weapon Name			Type																			Nb Hands
Gauntlet				TYPE:Simple.Light.Melee.Unarmed.Bludgeoning
Spells (Ray)			TYPE:Simple.RangedTouch.Spell
Spells (Touch)			TYPE:Simple
Unarmed Strike			TYPE:Simple.Light.Melee.Unarmed.Bludgeoning
Grapple				TYPE:Simple.Melee.Unarmed.Bludgeoning
# -- light melee
Dagger				TYPE:Simple.Light.Melee.Ranged.Dagger.Piercing.Slashing.MeleeSlashing.MeleePiercing.RangedPiercing.RangedSlashing
Dagger (Punching)			TYPE:Simple.Light.Melee.Dagger.Piercing.MeleePiercing
Gauntlet (Spiked)			TYPE:Simple.Light.Melee.Piercing.MeleePiercing.Unarmed
Mace (Light)			TYPE:Simple.Light.Melee.Bludgeoning.Mace
Sickle				TYPE:Simple.Light.Melee.Slashing.Sickle.MeleeSlashing
# -- 1-handers
Club					TYPE:Simple.OneHanded.Melee.Bludgeoning.Club
Mace (Heavy)			TYPE:Simple.OneHanded.Melee.Bludgeoning.MeleeBludgeoning
Morningstar				TYPE:Simple.OneHanded.Melee.Bludgeoning.MeleeBludgeoning.Piercing.MeleePiercing
Shortspear				TYPE:Simple.OneHanded.Melee.Piercing.MeleePiercing.Spear
# -- 2-handers
Longspear				TYPE:Simple.TwoHanded.Melee.Piercing.MeleePiercing.Spear.TwoHanded
Quarterstaff			TYPE:Simple.TwoHanded.Melee.Quarterstaff.TwoHanded.DoubleWeapon.Bludgeoning.MeleeBludgeoning
Spear					TYPE:Simple.TwoHanded.Melee.Piercing.MeleePiercing.Spear.TwoHanded
# -- Ranged
Blowgun				TYPE:Simple.Ranged.Piercing.RangedPiercing.Blowgun
Crossbow (Heavy)			TYPE:Simple.Ranged.Piercing.RangedPiercing.Crossbow.Archery										HANDS:2
Crossbow (Light)			TYPE:Simple.Ranged.Piercing.RangedPiercing.Crossbow.Archery										HANDS:2
Dart					TYPE:Simple.Thrown.Piercing.RangedPiercing
Javelin				TYPE:Simple.Thrown.Piercing.RangedPiercing.Spear
Sling					TYPE:Simple.Ranged.Bludgeoning.RangedBludgeoning

# Martial
# -- light
Axe (Throwing)			TYPE:Martial.Light.Thrown.Slashing.Axe
Hammer (Light)			TYPE:Martial.Light.Thrown.Melee.Bludgeoning.Hammer
Handaxe				TYPE:Martial.Light.Melee.Slashing.MeleeSlashing.Axe
Kukri					TYPE:Martial.Light.Melee.Slashing.MeleeSlashing
Pick (Light)			TYPE:Martial.Light.Melee.Piercing.MeleePiercing.Pick
Sap					TYPE:Martial.Light.Melee.Bludgeoning.MeleeBludgeoning
Shieldbash (Light)		TYPE:Martial.Light.Melee.Bludgeoning.MeleeBludgeoning
Spiked Armor			TYPE:Martial.Light.Melee.Piercing.MeleePiercing
Starknife				TYPE:Martial.Light.Melee.Ranged.Piercing.MeleePiercing.RangedPiercing.Dagger
Sword (Short)			TYPE:Martial.Light.Melee.Piercing.MeleePiercing.Sword
# 1-handers
Battleaxe				TYPE:Martial.OneHanded.Melee.Slashing.MeleeSlashing.Axe
Flail					TYPE:Martial.OneHanded.Melee.Bludgeoning.Flail.MeleeBludgeoning
Longsword				TYPE:Martial.OneHanded.Melee.Slashing.MeleeSlashing.Sword
Pick (Heavy)			TYPE:Martial.OneHanded.Melee.Piercing.MeleePiercing.Pick
Rapier				TYPE:Martial.OneHanded.Melee.Piercing.MeleePiercing.Sword
Scimitar				TYPE:Martial.OneHanded.Melee.Slashing.MeleeSlashing.Sword
Shieldbash (Heavy)		TYPE:Martial.OneHanded.Melee.Bludgeoning.MeleeBludgeoning
Trident				TYPE:Martial.OneHanded.Melee.Thrown.Piercing.RangedPiercing.MeleePiercing.Spear
Warhammer				TYPE:Martial.OneHanded.Melee.Bludgeoning.MeleeBludgeoning.Hammer
# 2-handers
Falchion				TYPE:Martial.TwoHanded.Melee.Slashing.MeleeSlashing.Sword.TwoHanded
Glaive				TYPE:Martial.TwoHanded.Melee.Slashing.MeleeSlashing.Polearm.TwoHanded
Greataxe				TYPE:Martial.TwoHanded.Melee.Slashing.MeleeSlashing.Axe.TwoHanded
Greatclub				TYPE:Martial.TwoHanded.Melee.Bludgeoning.MeleeBludgeoning.Club.TwoHanded
Flail (Heavy)			TYPE:Martial.TwoHanded.Melee.Bludgeoning.MeleeBludgeoning.Flail.TwoHanded
Greatsword				TYPE:Martial.TwoHanded.Melee.Slashing.MeleeSlashing.Sword.TwoHanded
Guisarme				TYPE:Martial.TwoHanded.Melee.Slashing.MeleeSlashing.Polearm.TwoHanded
Halberd				TYPE:Martial.TwoHanded.Melee.Slashing.MeleeSlashing.Polearm.TwoHanded.Piercing.MeleePiercing
Lance					TYPE:Martial.TwoHanded.Melee.Piercing.MeleePiercing.TwoHanded.Spear
Ranseur				TYPE:Martial.TwoHanded.Melee.Piercing.MeleePiercing.Polearm.TwoHanded
Scythe				TYPE:Martial.TwoHanded.Melee.Slashing.MeleeSlashing.Piercing.MeleePiercing.TwoHanded
Sword (Bastard)			TYPE:Martial.TwoHanded.Exotic.Melee.Slashing.MeleeSlashing.Sword.TwoHanded
Waraxe (Dwarven)			TYPE:Martial.TwoHanded.Exotic.Melee.Slashing.MeleeSlashing.Axe.TwoHanded.Dwarven
# --ranged
Longbow				TYPE:Martial.Ranged.Piercing.RangedPiercing.Bow.Archery										HANDS:2
Shortbow				TYPE:Martial.Ranged.Piercing.RangedPiercing.Bow.Archery										HANDS:2
# EXOTIC
# -- light
Kama					TYPE:Exotic.Light.Melee.Slashing.MeleeSlashing
Nunchaku				TYPE:Exotic.Light.Melee.Bludgeoning.MeleeBludgeoning
Sai					TYPE:Exotic.Light.Melee.Thrown.Bludgeoning.MeleeBludgeoning
Siangham				TYPE:Exotic.Light.Melee.Piercing.MeleePiercing
# -- 1-handers
Whip					TYPE:Exotic.OneHanded.Melee.Slashing.MeleeSlashing.Reach
# -- 2-handers
Axe (Orc Double)			TYPE:Exotic.TwoHanded.Melee.Slashing.MeleeSlashing.Orc.Axe.DoubleWeapon.TwoHanded
Chain (Spiked)			TYPE:Exotic.TwoHanded.Melee.Piercing.MeleePiercing.Reach.TwoHanded
Curve Blade (Elven)		TYPE:Exotic.TwoHanded.Melee.Slashing.MeleeSlashing.Sword.TwoHanded.Elven
Flail (Dire)			TYPE:Exotic.TwoHanded.Melee.Bludgeoning.MeleeBludgeoning.TwoHanded.Flail
Hammer (Gnome Hooked)		TYPE:Exotic.TwoHanded.Melee.Bludgeoning.MeleeBludgeoning.Piercing.MeleePiercing.Hammer.Pick.TwoHanded.Gnome
Sword (Two-Bladed)		TYPE:Exotic.TwoHanded.Melee.Slashing.MeleeSlashing.Sword.TwoHanded.DoubleWeapon
Urgrosh (Dwarven)			TYPE:Exotic.TwoHanded.Melee.Slashing.MeleeSlashing.Piercing.MeleePiercing.Axe.TwoHanded.DoubleWeapon.Dwarven
# -- ranged
Bolas					TYPE:Exotic.Thrown.Bludgeoning
Crossbow (Hand)			TYPE:Exotic.Ranged.Piercing.RangedPiercing.Crossbow.Archery
Crossbow (Repeating Heavy)	TYPE:Exotic.Ranged.Piercing.RangedPiercing.Crossbow.Archery										HANDS:2
Crossbow (Repeating Light)	TYPE:Exotic.Ranged.Piercing.RangedPiercing.Crossbow.Archery										HANDS:2
Net					TYPE:Exotic.Thrown.Net
Shuriken				TYPE:Exotic.Thrown.Piercing.RangedPiercing
Sling Staff (Halfling)		TYPE:Exotic.Ranged.Bludgeoning.RangedBludgeoning.Halfling

# SPECIALS
Flurry of Blows			TYPE:Special.Light.Melee.Unarmed.Bludgeoning.Monk

# Thrown Rocks
Rock					TYPE:Simple.Ranged.Bludgeoning.Thrown.Rock
